###############I###
#                 #
# #################
#             #   #
# ### ##### # # # #
#   # #   # # # # #
# # # ### # # # # #
# # #     # #   # #
###########O#######